11111111111111111111
10000000000000000001
10000000000000000001
10000000000000000001
10001111111111110001
10000000000000000001
10000000000000000001
10000000000000000001
10000022222000000001
10000002222000000001
10000000222000000001
10000000000000000001
10000000030200000001
10000000000000000001
10000000000000000001
10000000000000000001
10000000000040000001
10000000000000000001
10000000000000000001
11111111111111111111
