0000000000
0000000000
0000000000
0011111000
0000000000
0000220000
0000200000
0000200000
0000000000
0000000000
